Aback: adv. Take aback surprise, disconcert. [old english: related to *a2]

Abacus: n. (pl. -cuses) 1 Frame with wires along which beads are slid for calculating. 2 Archit. Flat slab on top of a capital. [latin from greek from hebrew]

Abaft: naut. —adv. In the stern half of a ship. —prep. Nearer the stern than. [from *a2, -baft: see *aft]

Abandon: —v. 1 Give up. 2 Forsake, desert. 3 (often foll. by to; often refl.) Yield to a passion, another's control, etc. —n. Freedom from inhibitions. Abandonment n. [french: related to *ad-, *ban]

Abandoned: adj. 1 Deserted, forsaken. 2 Unrestrained, profligate.

Abase: v. (-sing) (also refl.) Humiliate, degrade. Abasement n. [french: related to *ad-, *base2]

Abashed: predic. Adj. Embarrassed, disconcerted. [french es- *ex-1, baïr astound]

Abate: v. (-ting) Make or become less strong etc.; diminish. Abatement n. [french abatre from latin batt(u)o beat]

Abattoir: n. Slaughterhouse. [french abatre fell, as *abate]

Abbacy: n. (pl. -ies) Office or jurisdiction of an abbot or abbess. [latin: related to *abbot]

Abbé: n. (in france) Abbot or priest. [french from latin: related to *abbot]

Abbess: n. Head of a community of nuns.

Abbey: n. (pl. -s) 1 Building(s) occupied by a community of monks or nuns. 2 The community itself. 3 Building that was once an abbey.

Abbot: n. Head of a community of monks. [old english from latin abbas]

Abbreviate: v. (-ting) Shorten, esp. Represent (a word etc.) by a part of it. Abbreviation n. [latin: related to *brief]

Abc: n. 1 The alphabet. 2 Rudiments of a subject. 3 Alphabetical guide.

Abdicate: v. (-ting) 1 (usu. Absol.) Give up or renounce (the throne). 2 Renounce (a duty, right, etc.). Abdication n. [latin dico declare]

Abdomen: n. 1 The belly, including the stomach, bowels, etc. 2 The hinder part of an insect etc. Abdominal adj. [latin]

Abduct: v. Carry off or kidnap illegally. Abduction n. Abductor n. [latin duco lead]

Abeam: adv. At right angles to a ship's or an aircraft's length.

Aberdeen angus: n. Animal of a scottish breed of hornless black cattle. [aberdeen in scotland]

Aberdonian: —adj. Of aberdeen. —n. Native or citizen of aberdeen. [medieval latin]

Aberrant: adj. Deviating from what is normal or accepted. [latin: related to *err]

Aberration: n. 1 Aberrant behaviour; moral or mental lapse. 2 Biol. Deviation from a normal type. 3 Distortion of an image because of a defect in a lens or mirror. 4 Astron. Apparent displacement of a celestial body.

Abet: v. (-tt-) (usu. In aid and abet) Encourage or assist (an offender or offence). [french: related to *ad-, *bait]

Abeyance: n. (usu. Prec. By in, into) Temporary disuse. [french: related to *ad-, beer gape]

Abhor: v. (-rr-) Detest; regard with disgust. [latin: related to *horror]

Abhorrence: n. Disgust; detestation.

Abhorrent: adj. (often foll. by to) Disgusting or hateful.

Abide: v. (-ding; past abided or rarely abode) 1 (usu. In neg.) Tolerate, endure (can't abide him). 2 (foll. by by) a Act in accordance with (abide by the rules). b Keep (a promise). 3 Archaic remain, continue. [old english a- intensive prefix, *bide]

Abiding: adj. Permanent, enduring.

Abidjan: n. Capital of ivory coast, on the gulf of guinea. [abbr.]

Abigail: n. 1 Handmaid. 2 Maidservant; lady's waiting-woman. [hebrew avigayil]

Ability: n. 1 power or capacity to do or act physically or mentally. 2 specific skill or aptitude. [french: related to *able]

Abiotic: adj. Biol. Non-living. [greek: related to *a-1, *biotic]

Bannister: variant of *banister.

Bannock: n. Scot. & n. Engl. Round flat loaf, usually unleavened. [Old English]

Banns: n.pl. Notice announcing an intended marriage, read out in a parish church. [Pl. of *ban]

Banquet: —n. Sumptuous, especially formal, feast or dinner. —v. (-t-) attend, or entertain with, a banquet; feast. [French diminutive of banc bench]

Banquette: n. Upholstered bench, especially in a restaurant or bar. [French from Italian]

Banshee: n. Ir. & Scot. Wailing female spirit warning of death in a house. [Irish, = fairy woman]

Bantam: n. 1 a kind of small domestic fowl. 2 small but aggressive person. [Apparently from bantan in Java]

Bantamweight: n. 1 weight in certain sports between flyweight and featherweight, in amateur boxing 51–54 kg. 2 sportsman of this weight.

Banter: —n. Good-humored teasing. —v. 1 tease. 2 exchange banter. [Origin unknown]

Bantu: —n. (pl. Same or -s) 1 often offens. Member of a large group of central and southern African blacks. 2 group of languages spoken by them. —adj. Of these peoples or languages. [Bantu, = people]

Bantustan: n. S. Afr. Often offens. = *homeland 2.

Banyan: n. (also banian) Indian fig tree with self-rooting branches. [Portuguese from Sanskrit, = trader]

Baobab: n. African tree with a massive trunk and large pulpy fruit. [Probably African dial.]

Bap: n. Soft flattish bread roll. [Origin unknown]

Baptism: n. Symbolic admission to the Christian church, with water and usually name-giving.  Baptismal adj. [Greek baptizo baptize]

Baptism of fire: n. 1 initiation into battle. 2 painful initiation into an activity.

Baptist: n. 1 person who baptizes, especially John the Baptist. 2 (Baptist) Christian advocating baptism by total immersion.

Baptistery: n. (pl. -ies) 1 a part of a church used for baptism. B hist. Separate building used for baptism. 2 (in a Baptist chapel) receptacle used for immersion.

Baptize: v. (also -ise) (-zing or -sing) 1 administer baptism to. 2 give a name or nickname to.

Bar1: —n. 1 long piece of rigid material, especially used to confine or obstruct. 2 a something of similar form (bar of soap; bar of chocolate). B band of color or light. C heating element of an electric fire. D metal strip below the clasp of a medal, awarded as an extra distinction. E heraldry narrow horizontal stripe across a shield. 3 a counter for serving alcohol etc. on. B room or building containing it. C small shop or stall serving refreshments (snack bar). D counter for a special service (heel bar). 4 a barrier. B restriction (color bar; bar to promotion). 5 prisoner's enclosure in a lawcourt. 6 any of the sections into which a piece of music is divided by vertical lines. 7 (the bar) law a barristers collectively. B profession of barrister. —v. (-rr-) 1 a fasten with a bar or bars. B (usually foll. by in, out) shut or keep in or out. 2 obstruct, prevent. 3 (usually foll. by from) prohibit, exclude. 4 mark with stripes. —prep. Except.  be called to the bar be admitted as barrister. Behind bars in prison. [French]

Bar2: n. Esp. Meteorol. Unit of pressure, 105 newtons per square meter, approx. One atmosphere. [Greek baros weight]

Barathea: n. Fine wool cloth. [Origin unknown]

Barb: —n. 1 secondary backward-facing projection from an arrow, fish-hook, etc. 2 hurtful remark. 3 fleshy filament at the mouth of some fish. —v. 1 fit with a barb. 2 (as barbed adj.) (of a remark etc.) Deliberately hurtful. [Latin barba beard]

Barbarian: —n. 1 uncultured or brutish person. 2 member of a primitive tribe etc. —adj. 1 rough and uncultured. 2 uncivilized. [Greek barbaros foreign]

Barbaric: adj. 1 uncultured; brutal, cruel. 2 primitive.

Barbarism: n. 1 barbaric state or act. 2 non-standard word or expression.

Barbarity: n. (pl. -ies) 1 savage cruelty. 2 brutal act.

Barbarous: adj. = *barbaric 1.

Barbecue: —n. 1 a meal cooked over charcoal etc. outdoors. B party for this. 2 grill etc. Used for this. —v. (-ues, -ued, -uing) cook on a barbecue. [Spanish from Haitian]

Barbed wire: n. Wire with interwoven sharp spikes, used in fences and barriers.

Barbel: n. 1 freshwater fish with barbs. 2 = *barb n. 3. [Latin: related to *barb]

Barbell: n. Iron bar with removable weights at each end, used for weightlifting.

Barber: n. Person who cuts men's hair etc. by profession. [Medieval Latin barba beard]

Barberry: n. (pl. -ies) 1 shrub with yellow flowers and red berries. 2 its berry. [French Berberis]

Barber-shop: n. Colloq. Close harmony singing for four male voices.

Barber's pole: n. Pole with spiral red and white stripes as a barber's sign.

Barbican: n. Outer defense, especially a double tower above a gate or drawbridge. [French]

Barbie: n. Austral. Slang barbecue. [Abbreviation]

Bar billiards: n.pl. Form of billiards with holes in the table.

Barbiturate: n. Soporific or sedative drug from barbituric acid. [German, from the name Barbara]

Barbituric acid: n. Organic acid from which barbiturates are derived.

Barbour: n. Proper. Type of green waxed jacket. [Barbour, name of a draper]

Barcarole: n. 1 gondoliers' song. 2 music imitating this. [Italian barca boat]

Bar code: n. Machine-readable striped code on packaging etc.

Bus:  —n. (pl. Buses or us busses) 1 large esp. Public passenger vehicle, usu. Travelling a fixed route. 2 colloq. Car, aeroplane, etc. —v. (buses or busses, bussed, bussing) 1 go by bus. 2 us transport by bus, esp. To aid racial integration. [abbreviation of *omnibus]

Connect: v. 1 (often followed by to, with) join (two things, or one thing with another). 2 be joined or joinable. 3 (often followed by with) associate mentally or practically. 4 (followed by with) (of a train etc.) Be timed to arrive with another, so passengers can transfer. 5 put into communication by telephone. 6 a (usually in passive; followed by with) associate with others in relationships etc. B be meaningful or relevant. 7 colloq. Hit or strike effectively. [Latin necto nex- bind]

Connecting-rod: n. Rod between the piston and crankpin etc. in an internal combustion engine.

Connection: n. (also connexion) 1 connecting or being connected. 2 point at which two things are connected. 3 link, especially by telephone. 4 connecting train etc. 5 (often in pl.) Relative or associate, especially one with influence. 6 relation of ideas.

Connective: adj. Connecting, especially of body tissue connecting, separating, etc., organs etc.

Connector: n. Thing that connects.

Conning tower: n. 1 superstructure of a submarine containing the periscope. 2 armored wheel-house of a warship. [from *con4]

Connive: v. (-ving) 1 (followed by at) disregard or tacitly consent to (a wrongdoing). 2 (usually followed by with) conspire.  connivance n. [Latin conniveo shut the eyes]

Connoisseur: n. (often followed by of, in) expert judge in matters of taste. [French connaître know]

Connote: v. (-ting) 1 (of a word etc.) Imply in addition to the literal or primary meaning. 2 mean, signify.  connotation n. Connotative adj. [Medieval Latin: related to *note]

Connubial: adj. Of marriage or the relationship of husband and wife. [Latin nubo marry]

Conquer: v. 1 a overcome and control militarily. B be victorious. 2 overcome by effort.  conqueror n. [Latin conquiro win]

Conquest: n. 1 conquering or being conquered. 2 a conquered territory. B something won. 3 person whose affection has been won.

Consanguineous: adj. Descended from the same ancestor; akin.  consanguinity n. [Latin sanguis blood]

Conscience: n. Moral sense of right and wrong, especially as affecting behavior.  in all conscience colloq. By any reasonable standard. On one's conscience causing one feelings of guilt. Prisoner of conscience person imprisoned by the state for his or her political or religious views. [Latin: related to *science]

Conscience money: n. Sum paid to relieve one's conscience, especially regarding a payment previously evaded.

Conscience-stricken: adj. (also conscience-struck) made uneasy by a bad conscience.

Conscientious: adj. Diligent and scrupulous.  conscientiously adv. Conscientiousness n. [Medieval Latin: related to *conscience]

Conscientious objector: n. Person who for reasons of conscience objects to military service etc.

Conscious: —adj. 1 awake and aware of one's surroundings and identity. 2 (usually followed by of or that) aware, knowing. 3 (of actions, emotions, etc.) Realized or recognized by the doer; intentional. 4 (in comb.) Aware of; concerned with (fashion-conscious). —n. (preceded by the) the conscious mind.  consciously adv. Consciousness n. [Latin scio know]

Conscript: —v. Summon for compulsory state (especially military) service. —n. Conscripted person.  conscription n. [Latin scribo write]

Consecrate: v. (-ting) 1 make or declare sacred; dedicate formally to religious or divine purpose. 2 (followed by to) devote to (a purpose).  consecration n. [Latin: related to *sacred]

Consecutive: adj. 1 a following continuously. B in an unbroken or logical order. 2 gram. Expressing a consequence.  consecutively adv. [Latin sequor secut- follow]

Consensus: n. (often followed by of; often attrib.) General agreement or opinion. [Latin: related to *consent]

Consent: —v. (often followed by to) express willingness, give permission, agree. —n. Voluntary agreement, permission. [Latin sentio feel]

Consequence: n. 1 result or effect of what has gone before. 2 importance.  in consequence as a result. Take the consequences accept the results of one's choice or action. [Latin: related to *consecutive]

Consequent: adj. 1 (often followed by on, upon) following as a result or consequence. 2 logically consistent.

Consequential: adj. 1 consequent; resulting indirectly. 2 important.

Consequently: adv. & conj. As a result; therefore.

Conservancy: n. (pl. -ies) 1 body controlling a port, river, etc., or preserving the environment. 2 official environmental conservation. [Latin: related to *conserve]

Conservation: n. Preservation, especially of the natural environment. [Latin: related to *conserve] Conservationist n. Supporter of environmental conservation.

Conservation of energy: n. Principle that the total quantity of energy in any system that is not subject to external action remains constant.

Conservative: —adj. 1 averse to rapid change. B (of views, taste, etc.) Moderate, avoiding extremes. 2 (of an estimate etc.) Purposely low. 3 (usually Conservative) of conservatives or the Conservative Party. 4 tending to conserve. —n. 1 conservative person. 2 (usually Conservative) supporter or member of the Conservative Party.  conservatism n. [Latin: related to *conserve]

Conservative Party: n. Political party promoting free enterprise and private ownership.

Conservatoire: n. (usually European) school of music or other arts. [French from Italian]

Conservatory: n. (pl. -ies) 1 greenhouse for tender plants, especially attached to a house. 2 especially US = *conservatoire. [Latin and Italian: related to *conserve]

Conserve: —v. (-ving) keep from harm or damage, especially for later use. —n. Fresh fruit jam. [Latin servo keep]

Consider: v. 1 contemplate mentally, especially in order to reach a conclusion. 2 examine the merits of. 3 look attentively at. 4 take into account; show consideration or regard for. 5 (followed by that) have the opinion. 6 regard as. 7 (as considered adj.) Formed after careful thought (a considered opinion).  all things considered taking everything into account. [French from Latin]

Considerable: adj. 1 much; a lot of (considerable pain). 2 notable, important.  considerably adv.

Considerate: adj. Thoughtful towards others






